NO texture/greystone.xpm
SO texture/purplestone.xpm
WE texture/redbrick.xpm
EA texture/wood.xpm

F 126,200,80
C 135,206,235

1111111111111111111111111
1000000000110000000000001
1011000001110000000000001
100100000000000000000000111111111
111111111010000001110000000000001
100000000001000001110111111111111
11110111111111011100000010001
11110111111111011101010010001
110000001111010111000010W0001
10000000000000001100000000001
10000000000000001101010000001
1100000111010101111101111000111
11110111 1110101 101111010001
11111111 1111111 11111111111
