NO texture/greystone.xpm
SO texture/purplestone.xpm
WE texture/redbrick.xpm
EA texture/wood.xpm

F 126,200,80
C 135,206,235

1111111111111111111
1001001001001001001
1001001001001001001
1001001001001001001
1001001000001001001
100000000W00000000D
1000011111111000001
1111000000000001111
1000000101010000001
1111111111111111111
