NO texture/greystone.xpm
SO texture/purplestone.xpm
WE texture/redbrick.xpm
EA texture/wood.xpm

F 126,200,80
C 135,206,235

1111111111111111111111111
1000000000110000000000001
101100D001110000000000001
100100000000000000000000111111111
111111111011000001110000000000001
100000000011000001110111111111111
111101111111111D111111111111
11110000000000000101010010001
110000001101010N0100000010001
10000000000000000100000000001
10000000000000001101010000001
1100000111010101111101111000111
11110111 1110101 101111010001
11111111 1111111 111111111111
