1111111111111111111111
1000000000000000000001
1000000011111111111111
1000000000000000000001
1001100111100000011101
1001000000000000000101
1000000011111111110101
1010000000000000000101
101100N000111111111101
1000000000000000000001
1111111111111111111111