1111111111111111111111
1000000000000000000001
1011111111111111111111
1010000000000000000001
1010111111111111111101
1010100000000000000101
1010111111111111110101
1010000000000000000101
101100N000111111111101
1000000000000000000001
1111111111111111111111